###########
#         #
#         #
# PXO   ###
#         #
# OX      #
###########
